ETTTTTTTTTTTETTTTTTTTTTTET
TTTTTTTTTTTTTTTTTTTTTTTTTT
TTBBTTBBTTBBTTBBTTBBTTBBTT
TTBBTTBBTTBBTTBBTTBBTTBBTT
TTBBTTBBTTBBTTBBTTBBTTBBTT
TTBBTTBBTTBBTTBBTTBBTTBBTT
TTBBTTBBTTBBAABBTTBBTTBBTT
TTBBTTBBTTBBAABBTTBBTTBBTT
TTBBTTBBTTBBTTBBTTBBTTBBTT
TTBBTTBBTTTTTTTTTTBBTTBBTT
TTBBTTBBTTTTTTTTTTBBTTBBTT
TTTTTTTTTTBBTTBBTTTTTTTTTT
TTTTTTTTTTBBTTBBTTTTTTTTTT
TTTTBBBBTTTTTTTTTTBBBBTTTT
AATTBBBBTTTTTTTTTTBBBBTTAA
TTTTTTTTTTBBTTBBTTTTTTTTTT
TTTTTTTTTTBBBBBBTTTTTTTTTT
TTBBTTBBTTBBBBBBTTBBTTBBTT
TTBBTTBBTTBBTTBBTTBBTTBBTT
TTBBTTBBTTBBTTBBTTBBTTBBTT
TTBBTTBBTTBBTTBBTTBBTTBBTT
TTBBTTBBTTTTTTTTTTBBTTBBTT
TTBBTTBBTTTTTTTTTTBBTTBBTT
TTBBTTBBTTTBBBBTTTBBTTBBTT
TTTTTTTTTPTBFTBTTTTTTTTTTT
TTTTTTTTTTTBTTBTTTTTTTTTTT